20 20 20
.O.OO....O......O.O.
.O...O.......O....OO
.O..O...O.O.........
....OO....O.O...O..O
O..........O..O....O
..................O.
........O...O.......
....OO....O..O......
.O.........OH..OO...
....O......OO.......
.......O....O.....OO
...........O..O.....
...................O
.O.OOO...O..........
....O........O.....O
....O.O.............
.O.OO..OO...O.......
..O..O..O.....O...O.
.........OO.........
..O..O......OO......
5 9
5 11
13 17
17 19
11 1
2 5
16 1
2 3
7 6
18 17
8 14
18 1
3 11
19 8
1 11
1 14
8 4
8 5
11 6
6 6
